1305 1305 200 200 945 600
1182 1305 124 200 889 600
1059 1305 124 200 833 600
936  1305 124 200 777 600
813  1305 124 200 721 600
690  1305 124 200 665 600
567  1305 124 200 609 600
444  1305 124 200 553 600
321  1305 124 200 497 600
198  1305 124 200 441 600
0    1305 200 200 351 600
0    1182 200 124 351 544
0    1059 200 124 351 488
0    936  200 124 351 432
0    813  200 124 351 376
0    690  200 124 351 320
0    567  200 124 351 264
0    444  200 124 351 208
0    321  200 124 351 152
0    198  200 124 351 96
0    0    200 200 385 6 
198  0    124 200 441 6
321  0    124 200 497 6
444  0    124 200 553 6
567  0    124 200 609 6
690  0    124 200 665 6
813  0    124 200 721 6
936  0    124 200 777 6
1059 0    124 200 833 6
1182 0    124 200 889 6
1305 0    200 200 944 40
1305 198  200 124 944 96
1305 321  200 124 944 152
1305 444  200 124 944 208
1305 567  200 124 944 264
1305 690  200 124 944 320
1305 813  200 124 944 376
1305 936  200 124 944 432
1305 1059 200 124 944 488
1305 1182 200 124 944 544
60 2 10 30 90 160 250 50 50 30 
60 4 20 60 180 320 450 50 50 30
100 6 30 90 270 400 550 50 50 50
100 6 30 90 270 400 550 50 50 50
120 8 40 100 300 450 600 50 50 60
140 10 50 150 450 625 750 100 100 70
140 10 50 150 450 625 750 100 100 70
160 12 60 180 500 700 900 100 100 80
180 14 70 200 550 750 950 100 100 90
180 14 70 200 550 750 950 100 100 90
200 16 80 220 600 800 1000 100 100 100
220 18 90 250 700 875 1050 150 150 110
220 18 90 250 700 875 1050 150 150 110
240 20 100 300 750 925 1100 150 150 120
260 22 110 330 800 975 1150 150 150 130
260 22 110 330 800 975 1150 150 150 130
280 24 120 360 850 1025 1200 150 150 140
300 26 130 390 900 1100 1275 200 200 150
300 26 130 390 900 1100 1275 200 200 150
320 28 150 450 1000 1200 1400 200 200 160
350 35 175 500 1100 1300 1500 200 200 175
400 50 200 600 1400 1700 2000 200 200 200
1008 627 945 627 889 627 833 627 777 627 721 627 665 627 609 627 553 627 497 627
441 627 441 570 441 516 441 462 441 408 441 354 441 300 441 245 441 191 441 137
441 78 497 78 553 78 609 78 665 78 721 78 777 78 833 78 889 78 945 78
1013 78 1013 137 1013 191 1013 245 1013 300 1013 354 1013 408 1013 462 1013 516 1013 570
1008 641 945 641 889 641 833 641 777 641 721 641 665 641 609 641 553 641 497 641
427 627 427 570 427 516 427 462 427 408 427 354 427 300 427 245 427 191 427 137
441 64 497 64 553 64 609 64 665 64 721 64 777 64 833 64 889 64 945 64
1027 78 1027 137 1027 191 1027 245 1027 300 1027 354 1027 408 1027 462 1027 516 1027 570
1008 655 945 655 889 655 833 655 777 655 721 655 665 655 609 655 553 655 497 655
413 627 413 570 413 516 413 462 413 408 413 354 413 300 413 245 413 191 413 137
441 50 497 50 553 50 609 50 665 50 721 50 777 50 833 50 889 50 945 50
1041 78 1041 137 1041 191 1041 245 1041 300 1041 354 1041 408 1041 462 1041 516 1041 570
1008 669 945 669 889 669 833 669 777 669 721 669 665 669 609 669 553 669 497 669  
399 627 399 570 399 516 399 462 399 408 399 354 399 300 399 245 399 191 399 137  
441 36 497 36 553 36 609 36 665 36 721 36 777 36 833 36 889 36 945 36   
1055 78 1055 137 1055 191 1055 245 1055 300 1055 354 1055 408 1055 462 1055 516 1055 570 