60 2 10 30 90 160 250 50 50 30 
60 4 20 60 180 320 450 50 50 30
100 6 30 90 270 400 550 50 50 50
100 6 30 90 270 400 550 50 50 50
120 8 40 100 300 450 600 50 50 60
140 10 50 150 450 625 750 100 100 70
140 10 50 150 450 625 750 100 100 70
160 12 60 180 500 700 900 100 100 80
180 14 70 200 550 750 950 100 100 90
180 14 70 200 550 750 950 100 100 90
200 16 80 220 600 800 1000 100 100 100
220 18 90 250 700 875 1050 150 150 110
220 18 90 250 700 875 1050 150 150 110
240 20 100 300 750 925 1100 150 150 120
260 22 110 330 800 975 1150 150 150 130
260 22 110 330 800 975 1150 150 150 130
280 24 120 360 850 1025 1200 150 150 140
300 26 130 390 900 1100 1275 200 200 150
300 26 130 390 900 1100 1275 200 200 150
320 28 150 450 1000 1200 1400 200 200 160
350 35 175 500 1100 1300 1500 200 200 175
400 50 200 600 1400 1700 2000 200 200 200
1008 615 935 615 879 615 823 615 767 615 711 615 655 615 599 615 543 615 487 615 
431 615 431 555 431 501 431 442 431 388 431 334 431 280 431 225 431 171 431 117
441 55 497 55 553 55 609 55 665 55 721 55 777 55 833 55 889 55 945 55
995 63 995 110 995 171 995 225 995 280 995 334 995 388 995 442 995 496 995 550
1008 630 935 630 879 630 823 630 767 630 711 630 655 630 599 630 543 630 487 630 
417 615 417 555 417 501 417 442 417 388 417 334 417 280 417 225 417 171 417 117
441 40 497 40 553 40 609 40 665 40 721 40 777 40 833 40 889 40 945 40
1012 63 1012 110 1012 171 1012 225 1012 280 1012 334 1012 388 1012 442 1012 496 1012 550
1008 645 935 645 879 645 823 645 767 645 711 645 655 645 599 645 543 645 487 645 
403 615 403 555 403 501 403 442 403 388 403 334 403 280 403 225 403 171 403 117
441 25 497 25 553 25 609 25 665 25 721 25 777 25 833 25 889 25 945 25
1027 63 1027 110 1027 171 1027 225 1027 280 1027 334 1027 388 1027 442 1027 496 1027 550
1008 660 935 660 879 660 823 660 767 660 711 660 655 660 599 660 543 660 487 660 
389 615 389 555 389 501 389 442 389 388 389 334 389 280 389 235 389 171 389 117  
441 10 497 10 553 10 609 10 665 10 721 10 777 10 833 10 889 10 945 10   
1040 63 1040 110 1040 171 1040 225 1040 280 1040 334 1040 388 1040 442 1040 496 1040 550 